wwwwwwwwwwwwwwwwwb
w               wb
w               wb
w               wb
w               wb
w              gwb
w          wwwwwwb
w               wb
ws      w       wb
wwwwwwwwwwwwwwwww